sentence	paraphrase	reference
And the cult cars from the 1950s have been driving around Havana ever since, because the once imported Zhiguli and Fiat vehicles have decayed in the salty and damp weather.	And the cult cars from the 1950s have been driving around Havana ever since, because of the once imported Zhiguli and Fiat vehicles ' decay in the salty and damp weather.	 Und die Kultautos der Fünfziger fahren in Havanna bis heute herum, weil die einst importierten Schigulis und Fiats in der salzigen und feuchten Luft schon längst auseinandergefallen sind. 
«They should end as they began: within the Security Council.»	«They should end at their beginning: within the Security Council.»	 Sie müssen so enden, wie sie begonnen haben: im Sicherheitsrat. 
Anderson took 32 first-class wickets at 33 runs each to earn a place on this tour.	Anderson took 32 first-class wickets at 33 runs each for earning a place on this tour.	 Anderson nahm 32 erstklassige Wickets mit je 33 Runs, um eine Position in dieser Tour zu verdienen. 
He had come back to fight.	He had come back for fight.	 Er war zurückkommen, um zu kämpfen. 
"To celebrate the reunion, ""Live 1974,""a recording from their heyday, is released."	"For celebration of the reunion, ""Live 1974,""a recording from their heyday, is released."	" Zum Revival erscheint ein Mitschnitt aus ihrer großen Zeit ""Live 1974"". "
The search for Fossett was called off a month after he had disappeared.	The search for Fossett was called off a month after his disappearance.	 Die Suche nach Fossett war ein Monat nach dessen Verschwinden aufgegeben worden. 
The ongoing earnings and net earnings from financial transactions had fallen to nil compared to the same period in the previous year, while earnings from write-ups on demands and specific bonds as well as from the liquidation of accruals from credit transactions had shrunk by more than 70 percent to 5 million Euros.	The ongoing earnings and net earnings from financial transactions had fallen to nil compared to the same period in the previous year, as earnings from write-ups on demands and specific bonds as well as from the liquidation of accruals from credit transactions ' shrinkage by more than 70 percent to 5 million Euros.	 Die laufenden Erträge und die Nettoerträge aus Finanzgeschäften waren gegenüber dem Vorjahreszeitraum auf Null gefallen, die Erträge aus Zuschreibungen zu Forderungen und bestimmten Wertpapieren sowie aus der Auflösung von Rückstellungen im Kreditgeschäft um mehr als 70 Prozent auf 5 Millionen Euro gesunken. 
Because it does not have client deposits, it is more dependent on refinancing at the interbank market than other banks.	Because of its lack of client deposits, it is more dependent on refinancing at the interbank market than other banks.	 Sie ist stärker als andere Institute von der Refinanzierung am Interbankenmarkt abhängig, da sie keine Kundeneinlagen hat. 
Bastian Reinhardt would also have ` wished' for things to be ` more relaxed.'	Bastian Reinhardt would also have ` wished' for things for being ` more relaxed.'	" Auch Bastian Reinhardt hätte es sich ""entspannter gewünscht"". "
The Government provided £ 14bn to protect the deposits of Bradford & Bingley's 2.6 million savers.	The Government provided £ 14bn for protection of the deposits of Bradford & Bingley's 2.6 million savers.	 Die Regierung stellte 14 Milliarden Pfund zur Verfügung, um die Einlagen von Bradford & Bingleys 2,6 Millionen Kunden zu schützen. 
While Favre and Coles played catch, the defense battered Cardinals quarterback Kurt Warner.	With Favre and Coles ' play on catch, the defense battered Cardinals quarterback Kurt Warner.	 Während Favre und Coles Fangen spielten, nahm die Verteidigung Quarterback Kurt Warner auseinander. 
And yet, as the Hurston festival has expanded, a heightened level of hometown pride has also emerged.	And yet, as the Hurston festival 's expansion, a heightened level of hometown pride has also emerged.	 Und dennoch, zur selben Zeit zu der das Hurston-Festival größer wurde, wurde auch ein erhöhter Grad an Heimatstolz geboren. 
Probably there is not a more appropriate place in the world than Paris to present a fashion award, and probably there is not a living designer as exquisite as Valentino.	Probably there is not a more appropriate place in the world than Paris for presentation of a fashion award, and probably there is not a living designer as exquisite as Valentino.	 Wahrscheinlich gab es keinen geeigneteren Platz auf der Welt als Paris, um ein Premium der Mode zu präsentieren und es gab wahrscheinlich keinen wesentlich hervorragenden Modedesigner und Bonvivanten als Valentino. 
The administration board of AIG met on Sunday evening to consider possible cessations, according to the FT.	The administration board of AIG met on Sunday evening for consideration of possible cessations, according to the FT.	 Laut der FT traf sich der Verwaltungsrat der AIG Sonntag Abend, um mögliche Verkäufe zu überprüfen. 
A few hundred Belarusians gathered on Sunday evening at the closing of polling stations in the central square of Minsk to protest against the fraudulent elections.	A few hundred Belarusians gathered on Sunday evening at the closing of polling stations in the central square of Minsk for protest against the fraudulent elections.	 Einige hundert Weißrussen versammelten sich Sonntag Abend seit Schließung der Wahllokale auf dem Marktplatz von Minsk, um gegen den betrügerischen Charakter der Parlamentswahlen zu protestieren. 
The disappearance of Paul Newman brought vertigo to moviegoers this weekend, while his major roles collide on the black screen of memories.	The disappearance of Paul Newman brought vertigo to moviegoers this weekend, as his major roles ' collision on the black screen of memories.	 Der Tod Paul Newmans versetzte die Kinoliebhaber dieses Wochenende in Taumel, während auf dem dunklen Bildschirm der Erinnerungen all seine großen Rollen abgespielt wurden. 
As for holiday, things get complicated: so many days the first year, so many days after the third to get to a total of 15 days after a certain number of years.	As for holiday, things get complicated: so many days the first year, so many days after the third for getting to a total of 15 days after a certain number of years.	 Was den Urlaub angeht, so wird die Sache kompliziert: eine bestimmte Menge an Tagen im ersten Jahr, so und so viele nach dem dritten, um schließlich nach einer bestimmten Anzahl von Jahren 15 Ferientage zu erreichen. 
To sustain the sector between 16 and 18 million Euro a year are required».	For sustenance in the sector between 16 and 18 million Euro a year are required».	" Um den Sektor zu erhalten, wären zwischen 16 und 18 Millionen Euro im Jahr von Nöten"". "
There, it will take you a good few minutes to find the right sort of bin.	There, it will take you a good few minutes for finding the right sort of bin.	 Dort müsste man ein paar Minuten reservieren, um die geeigneten Mülltonnen zu finden.
The prize for chemistry was won by the Israeli Ada Jonath, together with the Americans Venkatraman Ramakrishnan and Thomas Steitz, for their work to clarify the structure and function of ribosomes.	The prize for chemistry was won by the Israeli Ada Jonath, together with the Americans Venkatraman Ramakrishnan and Thomas Steitz, for their work for clarification of the structure and function of ribosomes.	 Den Preis für Chemie hat die Israelin Ada Jonath zusammen mit den Amerikanern, Venkatraman Ramakrishnan und Thomas Steitz, für Aufklärung der Ribosom-Struktur und -Funktion erhalten.
Click here to find out more!	Click here for finding out more!	 Klicken Sie hier, um mehr zu erfahren!
Inside the convention center, people gathered around television screens to watch the march throughout the afternoon.	Inside the convention center, people gathered around television screens for watching the march throughout the afternoon.	 Im Inneren des Kongresszentrums versammelten sich die Menschen vor Fernsehbildschirmen, um den ganzen Nachmittag die Demonstration zu verfolgen.
A stage had been erected to accommodate the speakers, before a candlelit vigil, with the participation of former South African Cape Town archbishop, Desmond Tutu.	A stage had been erected for accommodation for the speakers, before a candlelit vigil, with the participation of former South African Cape Town archbishop, Desmond Tutu.	 Eine Bühne wurde aufgebaut, um die vorgesehenen Sprecher für einen Abend mit Kerzenlicht willkommen heissen zu können, unter Teilnahme des ehemaligen Süd-Afrikanischen Erzbischof, Desmond Tutu.
"According to RTL, partner for the singer's first tour, however, Johnny Hallyday may have been put into an artificial coma to avoid ""pain and complications""."	"According to RTL, partner for the singer's first tour, however, Johnny Hallyday may have been put into an artificial coma for avoidance of ""pain and complications""."	" Laut RTL, dem Partner während der letzten Tournee des Sängers, wurde Johnny Hallyday jedoch in ein künstliches Koma versetzt, um ""Schmerzen und Komplikationen"" zu vermeiden."
A total of 250 m2 are distributed amongst 12 rooms to carry out the latest and most innovative facial, body and hydrotherapy treatments.	A total of 250 m2 are distributed amongst 12 rooms for carrying out the latest and most innovative facial, body and hydrotherapy treatments.	 Die Gesamtfläche beträgt 250 m², die für die neuesten Gesichts- und Körperbehandlungen sowie für die Hydro-Therapie auf 12 Räume aufgeteilt ist, .
Moreover, Ferrovial, the autonomous government of Castile-La Mancha, and the University of Alcala de Henares signed a protocol of cooperation yesterday to create a Center for the Innovation of Intelligent Infrastructure.	Moreover, Ferrovial, the autonomous government of Castile-La Mancha, and the University of Alcala de Henares signed a protocol of cooperation yesterday for creation of a Center for the Innovation of Intelligent Infrastructure.	 Auf der anderen Seite haben Ferrovial, die Regierung von Kastilien-La Mancha und die Universität von Alcalá de Henares gestern ein Protokoll zur Zusammenarbeit zwecks Schaffung eines Innovationszentrums für intelligente Infrastrukturen unterzeichnet.
The Jerezano group is giving a period of 15 days for shareholders to express their interest in selling securities.	The Jerezano group is giving a period of 15 days for shareholders for expression of their interest in selling securities.	 Die Gruppe aus Jeréz gibt den Aktionären eine Frist von 15 Tagen, um ihr Interesse am Verkauf ihrer Aktien mitzuteilen.
Most people came to solve the same problems as usual - request for repairs, insured events etc.	Most people came for solution of the same problems as usual - request for repairs, insured events etc.	 Die meisten Leute sind hier, um die üblichen Probleme zu lösen - Reparaturanträge, Versicherungsangelegenheiten und ähnliches.
You need not be an NHL guy to appreciate the lazy foam.	You need not be an NHL guy for appreciation of the lazy foam.	 Und man muss nicht unbedingt ein berühmter Eishockeyspieler sein, um die Vorteile des Visco-Schaums schätzen zu lernen.
"""They are actually doing better because they have the beautiful evening experience and a good wake up when nothing hurts."""	"""They are actually doing better because of their beautiful evening experience and a good wake up when nothing hurts."""	" ""Sie sind eindeutig besser dran, denn nach dem ""herrlichen"" Erlebnis am Abend, wecken sie mit guter Laune auf, ohne dass irgendwo etwas weh tut."""
The prominent American Senator Joe Lieberman called upon other countries and companies to boycott Wikileaks.	The prominent American Senator Joe Lieberman called upon other countries and companies for boycotting Wikileaks.	 Der prominente amerikanische Senator Joe Lieberman rief indes andere Länder und Unternehmen zum Boykott von Wikileaks auf.
But this year, 12 years after the Khmer Rouge surrendered to the government, long-held loyalties are finally being challenged in Anlong Veng.	But this year, 12 years after the Khmer Rouge 's surrender to the government, long-held loyalties are finally being challenged in Anlong Veng.	 Doch dieses Jahr, 12 Jahre nach der Kapitulation der Khmer Rouge gegenüber der Regierung, werden langjährige Anhänger in Anlong Veng herausgefordert.
This meeting wasn't held yet, because the internal flood of the last years advised against confronting the subject.	This meeting wasn't held yet, because of the internal flood of the last years ' advice against confronting the subject.	 Dieser Termin steht noch aus, da infogle der internen Aufruhe der letzten Jahre das Angehen dieser Angelegenheit nicht ratsam war.
No special measures are contemplated for Wednesday evening to restrict the traffic of heavy loads.	No special measures are contemplated for Wednesday evening for restriction of the traffic of heavy loads.	 Für den Schwerverkehr wurden am Mittwochabend keinerlei spezifische beschränkende Maßnahmen vorgesehen.
The National Credit Union Administration (NCUA) is responsible for the US credit unions and intervenes in bankruptcies to protect customer deposits.	The National Credit Union Administration (NCUA) is responsible for the US credit unions and intervenes in bankruptcies for protection of customer deposits.	Die National Credit Union Administration (NCUA) ist für die US-Genossenschaftsbanken zuständig und springt bei Pleiten ein, um die Kundeneinlagen zu schützen.
The IBM share price rose by one percent before the markets opened following the announcement of Buffett's investment.	The IBM share price rose by one percent before the markets ' opening following the announcement of Buffett's investment.	Nach Bekanntwerden des Buffett-Investments stieg die IBM-Aktie vorbörslich um ein Prozent.
Instead, Buffett threw a decades-old principle out of the window to invest in the US technology industry.	Instead, Buffett threw a decades-old principle out of the window for investment in the US technology industry.	Stattdessen warf Buffett ein Jahrzehnte altes Prinzip über den Haufen und stieg in die US-Technologiebranche ein.
Ronaldo pounded a free kick into the nets from about 30 meters to take an early lead.	Ronaldo pounded a free kick into the nets from about 30 meters for taking an early lead.	Ronaldo jagte einen Freistoß aus rund 30 Metern zur frühen Führung in die Maschen.
In Lyman's case, she reported the alleged rape to military police less than an hour after it occurred.	In Lyman's case, she reported the alleged rape to military police less than an hour after its occurrence.	In Lymans Fall meldete sie die mutmaßliche Vergewaltigung der Militärpolizei weniger als eine Stunde nach dem Überfall.
The entity was created to prevent the fall on the margins of the society of untrained young men	The entity was created for prevention of the fall on the margins of the society of untrained young men	Die Organisation wurde zur Vermeidung der Marginalisierung von jungen Menschen ohne Berufsausbildung ins Leben gerufen.
In this place he remained for 49 days following the pronunciation of a second restriction order after the prosecutor dismissed the crimes of bribery and organized crime.	In this place he remained for 49 days following the pronunciation of a second restriction order after the prosecutor 's dismissal for the crimes of bribery and organized crime.	An diesem Ort blieb er 49 Tage nach einem zweiten Haftbefehl, nachdem der Beamte des Ministerio Público die Straftaten wegen Bestechung und organisierten Verbrechens verworfen hatte.
What did the candidate of Valley lack to be the new Miss Colombia?	What did the candidate of Valley lack for being the new Miss Colombia?	Was fehlte der Kandidatin del Valle, um die neue Miss Kolumbien zu sein?
The King of Jordan calls on president Assad to relinquish power	The King of Jordan calls on president Assad for relinquishment of power	Der König von Jordanien ruft Präsident Assad zum Machtabtritt auf
The Institute of Science of International Safety ISIS) bases itself on the recent report from the International Atomic Safety Agency (AIEA) and other documents from this UNO agency, to identify this researcher.	The Institute of Science of International Safety ISIS) bases itself on the recent report from the International Atomic Safety Agency (AIEA) and other documents from this UNO agency, for identification of this researcher.	Das Institut für Wissenschaft und Internationale Sicherheit ISIS basiert das Ergebnis auf dem kürzlich erschienenen Bericht der Internationalen Agentur für Atomsicherheit AIEA sowie anderen, von dieser UNO-Agentur ausgehenden Dokumenten zur Ermittlung dieses Wissenschaftlers.
Five companies combined their forces to implement this project.	Five companies combined their forces for implementation of this project.	Fünf Gesellschaften haben zur Verwirklichung dieses Projektes ihre Kräfte vereint.
Between 2006 and 2010, sales rose by 25% to reach 12.7 million units.	Between 2006 and 2010, sales rose by 25% for reach of 12.7 million units.	Zwischen 2006 und 2010 steigen die Verkäufe um 26% und etablieren sich mit einem Absatz von 12,7 Millionen Stück.
And it often costs over a hundred dollars to obtain the required identity card.	And it often costs over a hundred dollars for obtaining the required identity card.	Allerdings sind häufig mehr als hundert Dollar zu zahlen, um den erforderlichen Ausweis zu erhalten.
Blanc had achieved his goal when we qualified for the Euro.	Blanc had achieved his goal as our qualification for the Euro.	Blanc hatte sein Ziel erreicht, indem er uns für die EM qualifiziert hatte.
To avoid inflation, this award is regularly divided by two, probably by the end of 2012.	For avoidance of inflation, this award is regularly divided by two, probably by the end of 2012.	Zur Verhinderung einer Inflation wird diese Belohnung regelmäßig halbiert, wahrscheinlich vor Ende 2012.
Until now, women were favoured in life insurance prices, because they constitute a lower risk for insurers.	Until now, women were favoured in life insurance prices, because of their constitution with a lower risk for insurers.	Bis dahin genossen Frauen bei Lebensversicherungen einen Vorteil, weil sie für die Versicherungsgesellschaften objektiv ein geringeres Risiko darstellen.
The poll's organisers were also impressed by the idea of paying certain countries because they do not have a coastline, or the suggestion of allocating funding for a request for funding.	The poll's organisers were also impressed by the idea of paying certain countries because of their lack of coastline, or the suggestion of allocating funding for a request for funding.	Die Organisatoren der Umfrage waren auch von der Idee beeindruckt, dass bestimmte Länder Geld dafür erhalten sollten, dass sie kein Meer haben, oder aber von der Idee, Fördergelder für Anträge auf Fördergelder zu geben.
I am looking for allies to share my opinions and vision.	I am looking for allies for sharing my opinions and vision.	Ich versuche, Verbündete für meine Ansichten und Visionen zu finden.
Counterfeiters from China and Indonesia will bring lots more of these products down to sell on the streets of Australia.	Counterfeiters from China and Indonesia will bring lots more of these products down for sale on the streets of Australia.	Chinesische und indonesische Fälscher werden weitaus größere Mengen dieser Produkte auf den Straßen Australiens anbieten.
Singapore seeks babies to save its economy	Singapore seeks babies for rescue in its economy	Singapur braucht Babys zur Rettung der Wirtschaft
Only three attempts could be made to extinguish the blaze.	Only three attempts could be made for extinguishing the blaze.	Nun konnten drei Löschangriffe gestaltet werden.
At the beginning of September, the elite in the field of European space research met in Paris to discuss proposals for such missions.	At the beginning of September, the elite in the field of European space research met in Paris for discussion of proposals for such missions.	Anfang September traf sich in Paris die Elite der europäischen Weltraumforschung, um Vorschläge für solche Missionen zu diskutieren.
On Wednesday, the Centers for Disease Control and Prevention released a set of guidelines to manage children's food allergies at school.	On Wednesday, the Centers for Disease Control and Prevention released a set of guidelines for management of children's food allergies at school.	Am Mittwoch veröffentlichten die Centers for Disease Control and Prevention (CDC) eine Reihe von Richtlinien für den Umgang mit Lebensmittelallergien von Kindern an Schulen.
When his elderly mother died, a man from Wolfsburg devised a plan.	Upon his elderly mother 's death, a man from Wolfsburg devised a plan.	Als seine betagte Mutter starb, schmiedete ein Mann aus Wolfsburg einen Plan.
Firefighters abseil down cliff face to pluck the dog from certain death	Firefighters abseil down cliff face for plucking out the dog from certain death	Feuerwehrleute seilten sich an Felswand ab und retteten den Hund vor dem sicherem Tod
They had searched frantically for their missing dog and posted appeals on social networking sites after she had ran into the quarry following the minor accident.	They had searched frantically for their missing dog and posted appeals on social networking sites after her run into the quarry following the minor accident.	Sie hatten verzweifelt nach ihrer vermissten Hündin gesucht und Hilferufe in sozialen Netzwerken veröffentlicht, als sie nach dem kleinen Verkehrsunfall in den Steinbruch entlaufen war.
Previous tobacco vaccines failed because they contained antibodies.	Previous tobacco vaccines failed because of their containment of antibodies.	Frühere Tabakimpfstoffe schlugen fehl, weil sie Antikörper enthielten.
"At a pawnshop in Bendemeer shopping centre in Singapore, Janani Amirthalinga is swapping a gold bangle, ring and pair of earrings to pay her daughters"" school fees."	"At a pawnshop in Bendemeer shopping centre in Singapore, Janani Amirthalinga is swapping a gold bangle, ring and pair of earrings for payment of her daughters"" school fees."	In einem Pfandhaus im Einkaufszentrum Bendemeer in Singapur tauscht Janani Amirthalinga einen goldenen Armreif, einen Ring und ein Paar Ohrringe ein, um die Schulgebühren ihrer Töchter bezahlen zu können.
Pressure has been building on the FAA in recent years to ease restrictions on their use.	Pressure has been building on the FAA in recent years for easing restrictions on their use.	In den letzten Jahren hat sich der Druck auf die FAA erhöht, Einschränkungen für den Gebrauch zu lockern.
General Motors Co is recalling nearly 19,000 of its all-new 2014 Chevrolet Silverado and GMC Sierra pickup trucks to repair a problem with the manual reclining seatback, according to a notice from U.S. auto safety regulators on Friday.	General Motors Co is recalling nearly 19,000 of its all-new 2014 Chevrolet Silverado and GMC Sierra pickup trucks for repair following a problem with the manual reclining seatback, according to a notice from U.S. auto safety regulators on Friday.	General Motors rufe knapp 19.000 seiner brandneuen Chevrolet Silverado- und GMC Sierra-Pickup-Trucks mit Baujahr 2014 zurück, um ein Problem mit der manuell verstellbaren Sitzlehne zu beheben, so eine Mitteilung der US-amerikanischen Regulierungsbehörde für Fahrzeugsicherheit am Freitag.
That person will receive $ 250,000 to continue their extraordinary work.	That person will receive $ 250,000 for continuation of their extraordinary work.	Der Sieger erhält 250.000 Dollar zur Fortsetzung seiner außergewöhnlichen Arbeit.
Rainer Schulze is an expert when it comes to the Cologne underworld.	Rainer Schulze is an expert with its comeback to the Cologne underworld.	Rainer Schulze ist Experte in Sachen Kölner Unterwelt.
Phuket police interviewed Bamford for two days before she confessed to fabricating the story.	Phuket police interviewed Bamford for two days before her confession to fabricating the story.	Die Polizei in Phuket verhörte Bamford zwei Tage lang, bis sie gestand, sich die Geschichte ausgedacht zu haben.
India's new prime minister, Narendra Modi, is meeting his Japanese counterpart, Shinzo Abe, in Tokyo to discuss economic and security ties, on his first major foreign visit since winning May's election.	India's new prime minister, Narendra Modi, is meeting his Japanese counterpart, Shinzo Abe, in Tokyo for discussion of economic and security ties, on his first major foreign visit since winning May's election.	Indiens neuer Premierminister Narendra Modi trifft bei seinem ersten wichtigen Auslandsbesuch seit seinem Wahlsieg im Mai seinen japanischen Amtskollegen Shinzo Abe in Toko, um wirtschaftliche und sicherheitspolitische Beziehungen zu besprechen.
A hearing will be scheduled within a month for the judge to make a more permanent ruling on the law.	A hearing will be scheduled within a month for the judge for making a more permanent ruling on the law.	Innerhalb eines Monats wird eine Anhörung für den Richter angesetzt, um für das Gesetz eine dauerhaftere Entscheidung herbeizuführen.
When he died, on February 17 this year, he was 55.	At his death, on February 17 this year, he was 55.	Als er am 17. Februar dieses Jahres starb, war er 55.
"""Hello, Cancer Central,"" he would announce cheerily when they called."	"""Hello, Cancer Central,"" he would announce cheerily at their call."	"""Hallo, Krebszentrale,"" stellte er sich bei Anrufen fröhlich vor."
Eleven teams go head to head	Eleven teams go head for head	Elf Teams in Rundenwettkämpfen
More than 40,000 members of the security forces have been deployed to protect the government district.	More than 40,000 members of the security forces have been deployed for protection of the government district.	Mehr als 40 000 Sicherheitskräfte sind im Einsatz, um das Regierungsviertel zu schützen.
After Renzi had assumed his position as EU-Chairman in July, Mogherini embarked on her first state visit to Moscow.	After Renzi 's assumption of his position as EU-Chairman in July, Mogherini embarked on her first state visit to Moscow.	Nachdem Renzi im Juli seine Amtszeit als EU-Vorsitzender angetreten hatte, reiste Mogherini zu ihrem ersten Staatsbesuch nach Moskau.
The boy (12) had driven down to Oberusel in the morning, only to immediately go back up again.	The boy (12) had driven down to Oberusel in the morning, only for immediately going back up again.	Der Junge (12) war am Morgen nach Oberursel hinuntergefahren, um gleich darauf wieder auf die Höhe zu strampeln.
They went to work boldly, but often too uninspired in their offensive efforts.	They went for work boldly, but often too uninspired in their offensive efforts.	Sie gingen mutig ran, bei ihren offensiven Bemühungen aber oft zu einfallslos zu Werke.
"With ""Illinois"" (""Sufjan Stevens Invites You To: Come On Feel The Illinoise"") in 2005, a widely acclaimed masterpiece is released."	"With ""Illinois"" (""Sufjan Stevens Invites You For: coming On Feel The Illinoise"") in 2005, a widely acclaimed masterpiece is released."	"Mit ""Illinois"" (""Sufjan Stevens Invites You To: Come on Feel The Illinoise"") erscheint 2005 ein flächendeckend gefeiertes Meisterwerk."
BBC News went to meet one of the project's first graduates.	BBC News went for meeting with one of the project's first graduates.	BBC News hat einen der ersten Absolventen des Projekts getroffen.
Grocery wholesaler Metcash has kicked off a grassroots campaign to defend the market share of IGA retailers in South Australia and Western Australia ahead of a $ 700 million Aldi invasion.	Grocery wholesaler Metcash has kicked off a grassroots campaign for defense of the market share of IGA retailers in South Australia and Western Australia ahead of a $ 700 million Aldi invasion.	Lebensmittel-Großhändler Metcash hat eine Bodenständigkeits-Kampagne gestartet, um den Marktanteil der IGA-Einzelhändler in South Australia und Western Australia im Vorfeld einer 700 Millionen $ Aldi-Invasion zu verteidigen.
German Chancellor Angela Merkel and Austria called Tuesday for a special European Union summit next week to discuss the continent's immigration crisis.	German Chancellor Angela Merkel and Austria called Tuesday for a special European Union summit next week for discussion of the continent's immigration crisis.	Bundeskanzlerin Angela Merkel und Österreich forderten am Dienstag einen Sondergipfel der Europäischen Union, um die Einwanderungskrise des Kontinents zu besprechen.
Nearly two years after a college student died during a fraternity hazing ritual in Pennsylvania's Pocono Mountains, murder charges have been filed against five people.	Nearly two years after a college student 's death during a fraternity hazing ritual in Pennsylvania's Pocono Mountains, murder charges have been filed against five people.	Fast zwei Jahre, nachdem ein Student während eines schikanösen Rituals einer Studentenverbindung in Pocono Mountains, Pennsylvania, verstarb, werden Mordanklagen gegen fünf Personen eingereicht.
Kingfisher posted a fall in both half-year profit and sales after the group shouldered the cost of shutting stores.	Kingfisher posted a fall in both half-year profit and sales after the group 's shouldering the cost of shutting stores.	Kingfisher vermeldete einen Rückgang beim Halbjahresgewinn und den Umsätzen, nachdem die Gruppe die Kosten für das Schließen der Läden schulterte.
We will also need sufficient housing space to accommodate the influx of refugees over the next decades.	We will also need sufficient housing space for accommodation for the influx of refugees over the next decades.	Angesichts des Flüchtlingsstroms benötigen wir auch in den nächsten Jahrzehnten genügend Wohnraum.
Perhaps it's because a beautiful handbag can enhance any outfit.	Perhaps it's because of a beautiful handbag 's enhancement of any outfit.	Vielleicht liegt es daran, dass eine schöne Tasche jedes Outfit aufwertet.
Scots unemployment remains unchanged as UK total rises	Scots unemployment remains unchanged with UK total 's rise	Arbeitslosigkeit in Schottland bleibt unverändert, während sie im Vereinigten Königreich insgesamt steigt.
We often laugh a lot when we talk.	We often laugh a lot during our talk.	Wir lachen oft viel, wenn wir sprechen.
Friendship lies at the heart of the battle to meet this challenge.	Friendship lies at the heart of the battle for meeting this challenge.	Freundschaft ist das Herzstück im Kampf, um diese Herausforderung zu meistern.
The U.S. President and First Lady Michelle Obama will also host Xi and his wife Peng Liyuan at a state dinner that evening, after the two leaders have engaged in bilateral talks.	The U.S. President and First Lady Michelle Obama will also host Xi and his wife Peng Liyuan at a state dinner that evening, after the two leaders ' engagement in bilateral talks.	Der US-Präsident und die First Lady Michelle Obama werden an diesem Abend auch Gastgeber von Xi und seiner Frau Peng Liyuan bei einem Staats-Diner sein, nachdem die beiden Staatsführer bilaterale Gespräche geführt haben.
After the discussion aired, social media exploded in disapproval over Damon's comments.	After the discussion 's airing, social media exploded in disapproval over Damon's comments.	Nachdem die Diskussion ausgestrahlt wurde, explodierten die Sozialen Medien vor Missbilligung über Damons Kommentare.
Foodwatch is calling for consumers to protest against the EU plans under: www.quecksilber-aktion.foodwatch.de	Foodwatch is calling for consumers for protest against the EU plans under: www.quecksilber-aktion.foodwatch.de	Foodwatch ruft Verbraucher zum Protest gegen die Pläne der EU auf unter: www.quecksilber-aktion.foodwatch.de
When they arrive in Germany, they are often traumatised.	Upon their arrival in Germany, they are often traumatised.	Wenn sie in Deutschland ankommen, sind sie oft traumatisiert.
Simone, Gabby and Laurie all took the same path as Aly and Madison to make the Olympic team.	Simone, Gabby and Laurie all took the same path as Aly and Madison for making the Olympic team.	Simone, Gabby und Laurie schlugen alle den gleichen Weg wie Aly und Madison ein, um es ins olympische Team zu schaffen.
Give police powers to set up cordons around polling stations.	Give police powers for setting up cordons around polling stations.	Der Polizei die Befugnis geben, Absperrungen um Wahlstationen einzurichten.
To be clear, Byron's comments were related to the swimmer's performance, not to her as an individual.	For being clear, Byron's comments were related to the swimmer's performance, not to her as an individual.	Um eins klarzustellen, Byrons Kommentare bezogen sich auf die Leistung der Schwimmerin und nicht auf sie als Person.
Presenter and travel writer Ian Wright, 51, from Suffolk, scraped his tongue along a Euro note, a Piccadilly Circus hand rail, a train toilet's flush button and a Russian public telephone to prove the strength of his immune system.	Presenter and travel writer Ian Wright, 51, from Suffolk, scraped his tongue along a Euro note, a Piccadilly Circus hand rail, a train toilet's flush button and a Russian public telephone for proof of the strength of his immune system.	Der Moderator und Reiseautor Ian Wright, 51, aus Suffolk schabte seine Zuge auf einem Euro-Schein, einem Geländer am Piccadilly Circus, einem Spülknopf einer Zugtoilette sowie einem öffentlichen Telefon in Russland, um die Widerstandsfähigkeit seines Immunsystems unter Beweis zu stellen.
After he had beaten 16 rivals from within the Republican camp, doubt is now growing as to whether he will be successful in the race for the White House.	After his beating of 16 rivals from within the Republican camp, doubt is now growing as to whether he will be successful in the race for the White House.	Nachdem er 16 Rivalen innerhalb des eigenen republikanischen Lagers aus dem Rennen geworfen hat, wachsen nun die Zweifel an seinem Erfolg im Kampf um das Weiße Haus.
"Thuringia's ""Volks- und Raffeisen Bank"" in Altenburger Land hit the headlines in 2014 when their Skatbank branch imposed penalty interest on investments of more than three million euros."	"Thuringia's ""Volks- und Raffeisen Bank"" in Altenburger Land hit the headlines in 2014 with their Skatbank branch 's imposition of penalty interest on investments of more than three million euros."	Mit Strafzinsen für Einlagen ab drei Millionen Euro hatte die Thüringer Volks- und Raiffeisenbank Altenburger Land mit ihrer Skatbank-Filiale 2014 Schlagzeilen gemacht.
The bruising beating of the Boks, 7-5 in the semi-final earlier in the day, may have come back to bite them in the final.	The bruising beating of the Boks, 7-5 in the semi-final earlier in the day, may have come back for biting them in the final.	Die deutliche Niederlage der Boks, 7-5 im Halbfinale am selben Tag könnte auf sie im Finale zurückfallen.
However, the largest challenge and most difficult shift was when the pipe broke on the Kirchlauter elevated tank on 3 January one year.	However, the largest challenge and most difficult shift was at the pipe 's breaking on the Kirchlauter elevated tank on 3 January one year.	Die größte Herausforderung und der schwierigste Einsatz waren aber der Rohrbruch am Hochbehälter bei Kirchlauter an einem 3. Januar.
This search is now happening across Germany, because Sven S. might be travelling by car.	This search is now happening across Germany, because of Sven S. 's travel by car.	Mittlerweile bundesweit, denn Sven S. könnte mit dem Auto unterwegs sein.
Ethiopia's new prime minister, Hailemariam Desalegn, was plucked from relative obscurity to fill Mr. Meles's shoes.	Ethiopia's new prime minister, Hailemariam Desalegn, was plucked from relative obscurity for filling Mr. Meles's shoes.	Äthiopiens neuer Premierminister, Hailemariam Desalegn, wurde aus relativ undurchsichtigen Gründen ausgewählt, um die Stellung von Herrn Meles einzunehmen.
They generally only come to the surface in winter because they prefer water temperatures of around six degrees Celsius.	They generally only come to the surface in winter because of their preference for water temperatures of around six degrees Celsius.	Weil sie Wassertemperaturen um die sechs Grad Celsius bevorzugen, tauchen sie an der Oberfläche meist nur im Winter auf.
The device is still available online for fans to buy for a couple of euros, even though it comes from the stone age of the Internet.	The device is still available online for fans for purchase for a couple of euros, even though it comes from the stone age of the Internet.	Für ein paar Euro können Liebhaber die Geräte noch im Internet kaufen, doch sie stammen irgendwie aus der Steinzeit des Internetzeitalters.
Bulgaria's Prime Minister Bojko Borissow spoke up immediately to criticise the athlete.	Bulgaria's Prime Minister Bojko Borissow spoke up immediately for criticising the athlete.	Bulgariens Ministerpräsident Bojko Borissow meldete sich umgehend mit Kritik an der Athletin zu Wort.
The district authorities deliberately chose the less busy period of the school holidays for the extension of the right-hand turning lane, because it will cause delays.	The district authorities deliberately chose the less busy period of the school holidays for the extension of the right-hand turning lane, because of its causation of delays.	Für die Verlängerung der Rechtsabbiegespur hat der Landesbetrieb bewusst die verkehrsschwächere Zeit in den Schulferien ausgesucht, weil mit Behinderungen zu rechnen sei.
But what should you do when nobody listens to you?	But what should you do as nobody 's listening to you?	Aber was soll man denn machen, wenn einem nie jemand zuhört?
Nobody was in the mood to listen.	Nobody was in the mood for listening.	Niemand war in der Stimmung zuzuhören.
EPA Chief Pruitt Backtracks on Delaying Obama-Era Rules to Reduce Emissions	EPA Chief Pruitt Backtracks on Delaying Obama-Era Rules for Reduction in Emissions	EPA-Chef Pruitt zieht sich wegen des Hinauszögerns der Regeln der Obama-Era zur Verringerung der Emissionen zurück
Before Swiss concluded a contract with the Migros subsidiary, Barry Callebaut had supplied the chocolate bars, in collaboration with Hug.	Before Swiss ' conclusion of a contract with the Migros subsidiary, Barry Callebaut had supplied the chocolate bars, in collaboration with Hug.	Bevor die Swiss einen Vertrag mit der Migros Tochter abschloss, hatte Barry Callebaut in Zusammenarbeit mit Hug die Schokolade-Tablets geliefert.
Half as many were clocked up by Herbert Mair and Dorothee Reixinger, while Tamara Pfrommer, Petra Schleeh, Stefanie Stoll and Uwe Vetter each gave 500 millilitres of their lifeblood.	Half as many were clocked up by Herbert Mair and Dorothee Reixinger, with Tamara Pfrommer, Petra Schleeh, Stefanie Stoll and Uwe Vetter each 's gift of 500 millilitres of their lifeblood.	Halb so viele verbuchen Herbert Mair und Dorothee Riexinger, während Tamara Pfrommer, Petra Schleeh, Stefanie Stoll und Uwe Vetter zehn Mal je 500 Milliliter von ihrem Lebenssaft abgaben.
"Nine Weilermer Bikers, the ""Berlin outpost"", and two guest riders met in Wachenheim in North Palatinate to enjoy four days of trials and attractions."	"Nine Weilermer Bikers, the ""Berlin outpost"", and two guest riders met in Wachenheim in North Palatinate for enjoyment of four days of trials and attractions."	"Neun Weilermer Biker, der ""Berliner Außenposten"" und zwei Gastfahrer trafen sich in Wachenheim in der Nordpfalz, um vier Tage lang Trials und Sehenswürdigkeiten zu genießen."
That same year, Valdez won the International Press Freedom Award of the Committee to Protect Journalists for his courage in pursuing the Mexican drug story wherever it led.	That same year, Valdez won the International Press Freedom Award of the Committee for Protection of Journalists for his courage in pursuing the Mexican drug story wherever it led.	Im selben Jahr gewann Valdez den 'International Press Freedom Award' des Komitees zum Schutz von Journalisten für seinen Mut bei der Verfolgung der mexikanischen Drogengeschichte, wo auch immer sie hinführte.
How one activist came to learn the answer to the question: 'Whose Streets?'	How one activist came for learning about the answer to the question: 'Whose Streets?'	"Wie eine Aktivistin dazu kam, die Antwort auf die Frage zu lernen: ""Whose Streets?"""
"The White House Military Office requested the helicopter's presence in a fragmentary order, or FRAGO, barely 36 hours before the helicopter landed on the South Lawn for the ""unusual"" event, according to the records of Marine Helicopter Squadron One (HMX-1), the unit responsible for operating the helicopter."	"The White House Military Office requested the helicopter's presence in a fragmentary order, or FRAGO, barely 36 hours before the helicopter 's landing on the South Lawn for the ""unusual"" event, according to the records of Marine Helicopter Squadron One (HMX-1), the unit responsible for operating the helicopter."	Das Militärbüro des Weißen Hauses verlangte die Anwesenheit des Hubschraubers in einer fragmentarischen Ordnung oder FRAGO, kaum 36 Stunden bevor der Hubschrauber auf dem South Lawn landete, nach den Aufzeichnungen des Marine Helicopter Squadron One (HMX-1), der Einheit, die für den Betrieb des Hubschraubers verantwortlich ist.
